############################
#*...........##...........*#
#.####.#####.##.#####.####.#
#.####.#####.##.#####.####.#
#..........................#
#.####.##.########.##.####.#
#......##....##....##......#
######.##### ## #####.######
     #.##          ##.#     
     #.## ###GG### ##.#     
######.## #      # ##.######
      .   #      #   .      
######.## #      # ##.######
     #.## ######## ##.#     
     #.##          ##.#     
######.## ######## ##.######
#............##............#
#.####.#####.##.#####.####.#
#*..##................##..*#
###.##.##.########.##.##.###
#......##....##....##......#
#.##########.##.##########.#
#............P.............#
############################
