###################
# ....###....*... #
#.###.# #.###.### #
#.....# #.....#   ##
###.#####.#####.#   #
#P     G    ...#  ##
#.###.#####.###.# ##
#.....#   #.....#   #
#.###.# # #.###.# ##
#.....#   #..... . #
###################