###################
#P....###....*... #
#.###.# #.###.### #
#.....# #.....#   #
###.#####.#####.# #
#...   G    ...#  #
#.###.#####.###.# #
#.....#   #.....# #
#.###.# # #.###.# #
#.....#   #..... .#
###################