###################
# ....###....*... #
#.###.# #.###.### #
#.....# #.....#   #
###.#####.#####.# #
#P     G    ...#  #
#.###.#####.###.# #
#.....#   #.....# #
#.###.# # #.###.# #
#.....#   #..... .#
###################